111111111111111111111111111111111
100000000000001100000010000000001
100101000001000100000011100000001
100010001000000000000000100000001 
111111111000000000010N11000000001
100000000000000000000001111100111
100000000000000000000001000000001
100000001111001100000001000000001
100000001000000100000001000000001
100000001000000100000001000000001
111111111111111111111111111111111